4,0,0,0,1
0,5,6,0,0
0,3,5,4,0
0,2,4,0,3
2,2,0,3,0
