2,0,1,0,2
0,8,0,8,0
1,0,7,0,1
0,8,0,8,0
2,0,1,0,2
