0,0,3,0,0
0,4,1,8,0
2,3,2,7,2
0,6,0,5,0
0,0,1,0,0
