8,0,7,0,7
0,8,0,6,0
0,6,5,0,0
0,3,4,0,5
5,3,0,4,0
