2,2,2,2,0
8,8,8,0,8
4,4,0,4,4
0,7,3,7,0
0,0,1,0,0
