0,3,3,6,0
4,5,2,6,6
0,5,2,0,0
2,4,1,2,5
1,0,3,4,0
