3,0,6,0,3
0,0,6,0,0
6,6,6,6,6
0,0,6,0,0
3,0,6,0,3
