8,0,7,0,1
0,8,0,1,0
3,3,2,0,4
0,2,4,4,0
0,0,4,0,3
