1,0,7,0,1
0,1,7,1,0
8,8,7,8,8
0,1,7,1,0
1,0,7,0,1
