0,5,0,5,0
0,0,5,0,0
0,5,0,6,0
0,0,6,0,0
0,0,0,0,6
