8,7,0,0,0
0,7,0,8,0
0,0,8,0,0
0,0,0,8,0
0,0,0,0,0
