8,0,7,7,0
0,0,0,0,0
0,8,0,0,8
0,0,0,0,0
0,0,0,0,0
