0,0,8,0,0
0,2,7,2,0
0,7,8,7,0
4,2,7,2,4
4,4,8,4,4
