0,4,0,3,0
0,4,8,3,0
2,8,2,1,1
0,7,2,0,0
0,0,7,7,0
